1111111111111
1000000C00001
1101101111101
1101101111001
1101101111001
11C1100101001
11P11C10110E1
1111111111111
